2 2 2 2 2 2 2 2 2 2 2 2 2 2 2 2 2 2 2 2 2 2 2 2 2 2 2 2 2 2 2 2 2 2 2 2 2 2 2 2
2 2 2 2 2 1 1 1 1 2 2 2 2 2 2 2 2 2 2 2 2 2 2 2 1 1 1 1 1 1 1 1 1 1 1 1 2 2 2 2
2 2 1 1 1 3 3 3 3 1 1 2 2 2 2 2 2 2 2 2 2 2 2 1 6 6 6 6 6 6 6 6 6 6 6 1 2 2 2 2
2 1 1 3 3 3 3 3 3 3 3 1 2 2 2 2 2 2 2 2 2 2 1 6 6 6 6 6 6 6 6 6 6 6 6 6 1 2 2 2
2 1 3 3 3 3 3 3 3 3 3 3 1 2 2 2 2 2 2 2 2 1 6 6 6 6 6 6 6 6 6 6 6 6 6 1 1 2 2 2
2 1 3 3 3 4 4 4 3 4 4 4 4 1 2 2 2 2 2 2 1 6 6 6 6 6 6 6 6 6 6 6 1 1 1 1 2 2 2 2
2 1 3 3 3 4 1 5 3 4 1 5 5 1 2 2 2 2 2 2 1 6 6 6 6 6 6 6 6 6 1 1 1 2 2 2 2 2 2 2
2 1 3 3 3 4 4 4 3 4 4 4 4 1 2 2 2 2 2 2 1 6 6 6 6 6 6 6 1 1 1 2 2 2 2 2 2 2 2 2
2 1 3 3 3 3 3 3 3 3 3 3 3 1 2 2 2 2 2 2 1 6 6 6 6 6 6 6 6 1 1 1 1 2 2 2 2 2 2 2
2 1 3 3 1 1 1 3 1 1 1 3 3 1 2 2 2 2 2 2 1 6 6 6 6 6 6 6 6 6 6 6 1 1 1 1 1 1 1 2
2 1 3 3 1 2 1 3 1 2 1 3 3 1 2 2 2 2 2 2 1 6 6 6 6 6 6 6 6 6 6 6 6 6 6 6 6 6 1 2
2 1 3 3 1 2 1 3 1 2 1 3 3 1 2 2 2 2 2 2 1 1 6 6 6 6 6 6 6 6 6 6 6 6 6 6 6 1 2 2
2 1 3 3 1 2 1 3 1 2 1 3 3 1 2 2 2 2 2 2 2 1 6 6 6 6 6 6 6 6 6 6 6 6 6 6 1 2 2 2
2 1 1 1 1 2 1 1 1 2 1 1 1 1 2 2 2 2 2 2 2 2 1 1 1 6 6 6 6 6 6 6 6 6 1 1 2 2 2 2
2 2 2 2 2 2 2 2 2 2 2 2 2 2 2 2 2 2 2 2 2 2 2 2 2 1 1 6 6 6 6 6 1 1 1 2 2 2 2 2
2 2 2 2 2 2 2 2 2 2 2 2 2 2 2 2 2 2 2 2 2 2 2 2 2 2 2 1 1 1 1 1 1 2 2 2 2 2 2 2